+-+-+-+-+-+-+-+-+-+-+-+-+-+-+-+
|●                           x|
+ +-+-+-+-+ +-+-+-+ + +-+-+-+ +
| |       | |     | |   |     |
+ + +-+-+ + + +-+-+ +-+ + +-+ +
| | |   | |     |   |   | | | |
+ + + + + +-+-+ + +-+ + + + +-+
| |   | | |   | |   | | | |   |
+ +-+-+ + + +-+-+-+ + + + +-+ +
|       | | |     | | | | |   |
+-+-+-+-+ + +-+-+ + + + + + +-+
|         |       | | | | |   |
+ +-+-+-+-+-+-+-+ + + +-+ +-+ +
|       |         | |   |     |
+-+-+-+ + +-+-+-+-+ + + +-+-+ +
|         |         | | |     |
+-+-+-+-+-+ +-+-+-+-+ + + +-+-+ 
|         | |         | |     |
+ +-+-+-+ + +-+-+-+ +-+ + +-+ +
|       |         | | | | | | |
+-+-+-+ +-+-+-+-+ + + + +-+ + +
|     |         | | | |     | |
+ + +-+-+-+ +-+-+ + + +-+-+ + +
| |         |     | | |       |
+ +-+-+-+-+-+-+-+-+ + + +-+-+ +
|                   |       | |
+-+-+-+-+-+-+-+-+-+-+-+-+-+-+-+
